+-+-+-+-+-+-+-+-+-+-+
S     |       |     |
+-+-+ + +-+-+ + +-+ +
|   | | |     | |   |
+ +-+ + + +-+-+ +-+-+
|   |   | |       | |
+-+ + +-+ +-+-+ + + +
|   |   |       | | |
+ +-+ + +-+-+-+-+ + +
| |   | |     |   | |
+ + +-+ + +-+ + +-+ +
|   |   | |   |   | |
+-+-+ +-+ + +-+ + + +
|   |   | | |   | | |
+-+ +-+ +-+ + +-+ + +
|   | |   |   |   | |
+ +-+ +-+ +-+-+ +-+ +
| |     |     |   | |
+ + + + +-+-+ +-+ + +
|   | |       |     E
+-+-+-+-+-+-+-+-+-+-+